1111111111111111111
1000010000110000001
1000000P00000000001
10000000000C0000001
1011100000000000001
1E1000000000000C001
1111111111111111111