1111111111111111111
10000000010000C0001
10000C0001000000001
1000000000100000001
1000000000100000001
1000C00000100000001
1000000000000000001
10000000000000C0001
100EP000000000000011
1000000000000000001
1C00000000000C00001
1111111111111111111